111111111111111111111111111
101010100101101100000100001
100000000101000101001110001
111111110101010100010010001
100000010000000100100011001
111111110101111101000011101
100000000100000000000000001
101111100101111111100111111
101000100100000000000000001
101110100100000000011111111
100010100101111000000000001
111010111101000000000000001
101010000001010000000000001
101011111101010001111111001
111010000101000000000001001
110010000101111001111111001
110111111100000000000000001
110100000101011101000010001
110111110101010101000010001
100000010101010101000010001
111111010101010101000010001
100000010101010101000010011
101111111110101110110001001
101000000101010000010010011
101011111101100000001010001
111111111111111111111111111