11111111111111111111
10000000000000000001
11111101111101101011
10000001000001101001
10111111000000000011
10000000000001111111
11011110011001000001
10000010000000011101
10100010000001110101
10000010000000000101
10101011111110010001
10101000000000010101
10101111011111111101
10101000000000000001
10100010010111111101
10111110010001000101
10000000010000000301
10111000010011110101
40000000010010000101
11110000000010000101
10000010100011101101
10011010100000000101
10011010101110100101
10011010101000101101
10000010100000100001
12111111111111111111
