1111111111111111111111
1000001000100010000102
1110111010101010010001
1110000010001000011111
1111111111111311111111
