11111111111
10010000002
10010111101
10110111101
10110111101
10000000001
11111111111
