111111111
100000001
100000001
100010001
300010001
100000001
100000001
111111121
